gut|schlecht|good|bad
schön|hässlich|beautiful/pretty|ugly
groß|klein|big/large|small
jung|alt|young|old
schnell|langsam|fast/quick|slow
dick|dünn|fat/thick|thin
hoch|niedrig|high/tall|low/short
weit|nah|far|near
hell|dunkel|bright/light|dark
warm|kalt|warm|cold
süß|sauer|sweet|sour
stark|schwach|strong|weak
früh|spät|early|late
teuer|billig|expensive|cheap
viel|wenig|much/many|little/few
hart|weich|hard|soft
sauber|schmutzig|clean|dirty
glücklich|traurig|happy/lucky|sad
interessant|langweilig|interesting|boring
einfach|schwierig|easy/simple|difficult/hard
wichtig|unwichtig|important|unimportant
wahr|falsch|true|false
richtig|falsch|correct/right|wrong
bekannt|unbekannt|known/familiar|unknown/unfamiliar
freundlich|unfreundlich|friendly|unfriendly
fleißig|faul|hardworking/diligent|lazy
geduldig|ungeduldig|patient|impatient
ehrlich|unehrlich|honest|dishonest
höflich|unhöflich|polite|impolite
lieb|böse|dear/nice/kind|mean/angry
schlau|dumm|smart/clever|stupid/dumb
mutig|feige|brave/courageous|cowardly
gesund|krank|healthy|sick/ill
stumm|laut|silent/mute|loud
voll|leer|full|empty
arm|reich|poor|rich/wealthy
besser|schlechter|better|worse
mehr|weniger|more|less
genug|zu wenig|enough|too little
oft|selten|often|rarely/seldom
immer|nie|always|never
froh|traurig|happy/joyful|sad
müde|fit|tired|fit
schüchtern|selbstbewusst|shy|confident
nervös|ruhig|nervous|calm/quiet
optimistisch|pessimistisch|optimistic|pessimistic
realistisch|unrealistisch|realistic|unrealistic
logisch|unlogisch|logical|illogical
aktiv|passiv|active|passive
kreativ|unkreativ|creative|uncreative
produktiv|unproduktiv|productive|unproductive
positiv|negativ|positive|negative
modern|altmodisch|modern|old-fashioned
traditionell|unkonventionell|traditional|unconventional
flexibel|unflexibel|flexible|inflexible
dynamisch|statisch|dynamic|static
komplex|einfach|complex|simple
global|lokal|global|local
öffentlich|privat|public|private
kostenlos|kostenpflichtig|free|paid
sozial|asozial|social|antisocial
ökologisch|unökologisch|ecological|unecological
nachhaltig|nicht nachhaltig|sustainable|unsustainable
frisch|alt|fresh|old
saftig|trocken|juicy|dry
süß|bitter|sweet|bitter
glatt|rau|smooth|rough
scharf|stumpf|sharp|blunt
eng|weit|narrow|wide
dicht|locker|dense|loose
fein|grob|fine|coarse
fest|locker|firm/tight|loose
fett|mager|fat|lean
frech|artig|cheeky/impudent|well-behaved/good
fromm|gottlos|pious/devout|impious/godless
fröhlich|traurig|joyful/cheerful|sad
gefährlich|sicher|dangerous|safe
geizig|großzügig|stingy/miserly|generous
geliebt|gehasst|loved|hated
gerecht|ungerecht|just/fair|unjust/unfair
gespannt|entspannt|excited/tense|relaxed
getreu|untreu|loyal/faithful|unloyal/unfaithful
gewandt|ungeschickt|skilled/adept|unskilled/clumsy
glatt|holprig|smooth|bumpy
glücklich|unglücklich|happy/lucky|unhappy/unlucky
golden|silbern|golden|silver
großzügig|kleinlich|generous|petty/mean
gültig|ungültig|valid|invalid
gut|böse|good|evil
heftig|sanft|violent/fierce|gentle/soft
heiß|kalt|hot|cold
hoch|tief|high/tall|low/deep
hungrig|satt|hungry|full
interessiert|uninteressiert|interested|uninterested
kaputt|ganz|broken|whole
klar|unklar|clear|unclear
klug|dumm|clever/wise|stupid/foolish
komisch|ernst|funny/comical|serious
kurz|lang|short|long
laut|leise|loud|quiet
leicht|schwer|light|heavy
lustig|traurig|funny|sad
müde|wach|tired|awake
naiv|erfahren|naive|experienced
nass|trocken|wet|dry
nett|unfreundlich|nice|unfriendly
neugierig|uninteressiert|curious|uninterested
offen|geschlossen|open|closed
ordentlich|unordentlich|tidy/neat|untidy/messy
pünktlich|unpünktlich|punctual|unpunctual
ruhig|laut|quiet/calm|loud
scharf|mild|spicy/hot|mild
schlicht|auffällig|simple/plain|showy/flashy
schwarz|weiß|black|white
sicher|unsicher|safe/sure|unsure/unsafe
sonnig|wolkig|sunny|cloudy
stolz|demütig|proud|humble
stumm|redselig|silent/mute|talkative
tapfer|feige|brave/courageous|cowardly
treu|untreu|loyal/faithful|unloyal/unfaithful
trüb|klar|cloudy/murky|clear
überrascht|unbeeindruckt|surprised|unimpressed
unabhängig|abhängig|independent|dependent
unendlich|endlich|infinite|finite
unglaublich|glaubhaft|unbelievable|believable
uninteressant|interessant|uninteresting|interesting
unzufrieden|zufrieden|unsatisfied|satisfied