gut|schlecht|好|坏
schön|hässlich|漂亮|丑陋
groß|klein|大|小
jung|alt|年轻|老
schnell|langsam|快|慢
dick|dünn|胖|瘦
hoch|niedrig|高|低
weit|nah|远|近
hell|dunkel|亮|暗
warm|kalt|暖|冷
süß|sauer|甜|酸
stark|schwach|强|弱
früh|spät|早|晚
teuer|billig|贵|便宜
viel|wenig|多|少
hart|weich|硬|软
sauber|schmutzig|干净|脏
glücklich|traurig|快乐|悲伤
interessant|langweilig|有趣|无聊
einfach|schwierig|简单|难
wichtig|unwichtig|重要|不重要
wahr|falsch|真|假
richtig|falsch|正确|错误
bekannt|unbekannt|熟悉|陌生
freundlich|unfreundlich|友好|不友好
fleißig|faul|勤奋|懒惰
geduldig|ungeduldig|耐心|不耐烦
ehrlich|unehrlich|诚实|不诚实
höflich|unhöflich|礼貌|不礼貌
lieb|böse|亲爱|讨厌
schlau|dumm|聪明|愚蠢
mutig|feige|勇敢|胆怯
gesund|krank|健康|生病
stumm|laut|沉默|吵闹
voll|leer|满|空
arm|reich|穷|富
besser|schlechter|好|差
mehr|weniger|更多|更少
genug|zu wenig|足够|不足
oft|selten|经常|偶尔
immer|nie|总是|从不
froh|traurig|快乐|悲伤
müde|fit|累|精神
schüchtern|selbstbewusst|害羞|自信
nervös|ruhig|紧张|平静
optimistisch|pessimistisch|乐观|悲观
realistisch|unrealistisch|现实|不现实
logisch|unlogisch|逻辑|不合逻辑
aktiv|passiv|积极|消极
kreativ|unkreativ|创造力|缺乏创造力
produktiv|unproduktiv|生产力|缺乏生产力
positiv|negativ|积极|消极
modern|altmodisch|现代|老式
traditionell|unkonventionell|传统|非传统
flexibel|unflexibel|灵活|不灵活
dynamisch|statisch|动态|静态
komplex|einfach|复杂|简单
global|lokal|全球|本地
öffentlich|privat|公开|私密
kostenlos|kostenpflichtig|免费|收费
sozial|asozial|社会|反社会
ökologisch|unökologisch|生态|非生态
nachhaltig|nicht nachhaltig|可持续|不可持续
frisch|alt|新鲜|旧
saftig|trocken|多汁|干燥
süß|bitter|甜|苦
glatt|rau|光滑|粗糙
scharf|stumpf|锋利|钝
eng|weit|窄|宽
dicht|locker|密集|稀疏
fein|grob|细腻|粗糙
fest|locker|坚固|松动
fett|mager|肥|瘦
frech|artig|厚颜无耻|乖巧
fromm|gottlos|虔诚|不虔诚
fröhlich|traurig|快乐|悲伤
gefährlich|sicher|危险|安全
geizig|großzügig|吝啬|慷慨
geliebt|gehasst|爱|恨
gerecht|ungerecht|公正|不公正
gespannt|entspannt|兴奋|放松
getreu|untreu|忠诚|不忠诚
gewandt|ungeschickt|熟练|笨拙
glatt|holprig|光滑|坎坷
glücklich|unglücklich|幸福|不幸
golden|silbern|金|银
großzügig|kleinlich|慷慨|吝啬
gültig|ungültig|有效|无效
gut|böse|好|坏
heftig|sanft|剧烈|温柔
heiß|kalt|热|冷
hoch|tief|高|低
hungrig|satt|饥饿|饱
interessiert|uninteressiert|感兴趣|不感兴趣
kaputt|ganz|坏|好
klar|unklar|清晰|模糊
klug|dumm|聪明|愚蠢
komisch|ernst|滑稽|严肃
kurz|lang|短|长
laut|leise|响亮|安静
leicht|schwer|轻|重
lustig|traurig|有趣|悲伤
müde|wach|累|清醒
naiv|erfahren|天真|老练
nass|trocken|湿|干
nett|unfreundlich|好|不好
neugierig|uninteressiert|好奇|不感兴趣
offen|geschlossen|开放|关闭
ordentlich|unordentlich|整洁|凌乱
pünktlich|unpünktlich|准时|迟到
ruhig|laut|安静|吵闹
scharf|mild|辣|温和
schlicht|auffällig|朴素|花哨
schwarz|weiß|黑|白
sicher|unsicher|安全|不安全
sonnig|wolkig|晴朗|多云
stolz|demütig|骄傲|谦逊
stumm|redselig|沉默|健谈
tapfer|feige|勇敢|胆怯
treu|untreu|忠诚|不忠
trüb|klar|阴沉|晴朗
überrascht|unbeeindruckt|惊讶|不感兴趣
unabhängig|abhängig|独立|依赖
unendlich|endlich|无限|有限
unglaublich|glaubhaft|难以置信|可信
uninteressant|interessant|无趣|有趣
unzufrieden|zufrieden|不满意|满意
wertvoll|wertlos|有价值|无价值
wunderschön|hässlich|极好|丑陋
blind|sehend|瞎|视
blöd|gescheit|愚蠢|聪明
breit|schmal|宽|窄
bunt|einfarbig|五彩缤纷|单色
deutlich|undeutlich|清楚|模糊